11111111111111111111
10000000000000000001
10000000000000000001
10000000020000000001
10000000000000000001
11100111111111100111
10000000000000000001
10000000000000000001
11100111111111100111
10000000000000000001
10000000000000000001
11100111111111100111
10000000000000000001
10000040000004000001
11111111111111111111