10001111111111110001
10000000000000000001
10000002000020000001
10000111111111100001
10000000000000000001
10200000000000000201
11111000000000011111
10000000000000000001
10000000111100000001
10000000000000000001
10004000000000040001
10011110000001111001
10000000000000000001
10000002000020000001
10001111111111110001