11111111100111111111
10000000000000000001
10000000000000000001
10000000000000000001
10000000111100000001
10000000000000000001
10000000000000000001
10000002000030000001
10000111111111100001
10000000000000000001
10000000000000000001
10000000000000000001
10000000000000000001
10000400000000400001
11111111100111111111